1111111111111111
1............111
1............111
1............111
1............111
1............111
1............111
1............111
1............111
1111111111111111
................
................