1111111111
1111111111
1iggggj1kl11
1fdphomn11
1fde11op11
1acb111111
1111111111
1111111111
1111111111
1111111111
1111111111
1111111111